%%%%%%%%%%%%%%
% G          %
%  %    %%%%%%
%%%%      .G.%
% P%   .  %%%%
%         %..%
%%%       %  %
%.G .        %
%%%%%%%%%%%%%%
% % % %%%%%%%%
%%%%%%%%%%%%%%
