%%%%%%%%%%%%%%
%            %
%            %
%            %
%            %
% G          %
%            %
%           P%
%%%%%%%%%%%%%%
% %%%%%%%%%%%%
%%%%%%%%%%%%%%
