%%%%%%%%%%%%%%
% P          %
%%%%%%       %
%.        %%%%
%%%%        G%
%            %
%%%%         %
% G       G  %
%%%%%%%%%%%%%%
% % % %%%%%%%%
%%%%%%%%%%%%%%
