%%%%%%%%%%%%%%
% G          %
%%%%%%%%     %
%  G         %
%            %
%            %
%  P         %
%         G  %
%%%%%%%%%%%%%%
% % % %%%%%%%%
%%%%%%%%%%%%%%
